source_year,total_original_entries,entries_below_25k,entries_above_25k,original_sum_below_25k,original_sum_above_25k
2010,101,59,42,1063816.43,7101645.75
2011,72,31,41,558454.73,3022816.53
2012,58,23,35,466405.73,2933803.46
2013,42,21,21,367940.12,1387203.91
2014,76,41,35,685500.22,5154643.93
2015,78,37,41,679736.95,4650885797.96
2016,122,70,52,1316606.56,13281622.28
2017,96,58,38,1103561.97,11883066.08
2018,116,58,58,1106421.50,10646815.16
2019,99,41,58,736138.17,4854348.08
